{
  "id": "0",
  "name": "新手村",
  "width": 16,
  "height": 16,
  "tileWidth": 64,
  "tileHeight": 32,
  "tilesets": [],
  "layers": [
    {
      "name": "ground",
      "data": [
        [4, 4, 4, 4, 4, 4, 4, 4, 4, 4, 4, 4, 4, 4, 4, 4],
        [4, 1, 1, 1, 1, 1, 1, 1, 1, 1, 1, 1, 1, 1, 1, 4],
        [4, 1, 1, 1, 1, 1, 1, 1, 1, 1, 1, 1, 1, 1, 1, 4],
        [4, 1, 1, 5, 5, 5, 1, 1, 1, 1, 1, 1, 1, 1, 1, 4],
        [4, 1, 1, 5, 5, 5, 1, 2, 2, 2, 2, 1, 1, 1, 1, 4],
        [4, 1, 1, 5, 5, 5, 1, 2, 1, 1, 2, 1, 1, 1, 1, 4],
        [4, 1, 1, 1, 1, 1, 1, 2, 1, 1, 2, 1, 1, 1, 1, 4],
        [4, 1, 2, 2, 2, 2, 2, 2, 2, 2, 2, 2, 2, 2, 1, 4],
        [4, 1, 1, 1, 1, 1, 1, 2, 1, 1, 1, 1, 1, 1, 1, 4],
        [4, 1, 1, 3, 3, 1, 1, 2, 1, 1, 1, 1, 1, 1, 1, 4],
        [4, 1, 1, 3, 3, 1, 1, 2, 1, 6, 6, 6, 1, 1, 1, 4],
        [4, 1, 1, 3, 3, 1, 1, 2, 1, 6, 6, 6, 1, 1, 1, 4],
        [4, 1, 1, 1, 1, 1, 1, 2, 1, 1, 1, 1, 1, 1, 1, 4],
        [4, 1, 1, 1, 1, 1, 1, 2, 1, 1, 1, 1, 1, 1, 1, 4],
        [4, 1, 1, 1, 1, 1, 1, 1, 1, 1, 1, 1, 1, 1, 1, 4],
        [4, 4, 4, 4, 4, 4, 4, 4, 4, 4, 4, 4, 4, 4, 4, 4]
      ]
    }
  ]
}
